1111111111111
10010000000C1
1P00011111001
1P00110000001
1111111111111
