1111111111111
1001000000011
10V0011111001
1P0011E000001
1111111111111
